FAK = Frivilliga automobilkåren
FAO = Food and Agriculture Organiza-

tion of the United Nations
FBF = Fredrika Bremerförbundet
FBskftjM = Finlands Befolkningsskydds

förtjänstmedalj
FBU = Frivilliga befälsutbildningsrörel-

sen
FCIF = Försvarsväsendets civilmilitära

ingen j örsf örbund
FCS = Försvarsverkens civila personals

förbund

FDI = Federation Dentaire
Internationale
Fera = Föreningen för elektricitetens

rationella användning
FFI = Företagsekonomiska
forskningsinstitutet vid Handelshögskolan i Sthlm
FFrK = Finska Frihetskorsets orden
FFrM  = Finska Frihetsmedaljen
FGI = Federation Graphique
Internationale

FHK = Folkhushållningskommissionen
FHMM = Finsk minnesmedalj för
humanitär verksamhet
FHS = Försvarshögskolan
FIA = Federation Internationale de

T Automobile

FIATA = Federation Internationale
des Associations de Transports et
Assimilés

Fib = ab Folket i Bild
FID = Federation    Internationale    de

Documentation
FIDIC = Federation Internationale des

Ingénieurs-Conseil
FIFA  =  Federation Internationale  de

Football Association
FiForstS = Finska forstsamfundet
FIG(L) = Federation Internationale de

Gymnastique (Ling)
FIM   =  Federation  Internationale  des

Musiciens

FmlldrftjkG(S) = Finlands idrotts
förtjänstkors i guld (silver)
FinlLO = Finlands Lejons orden
FinlLTn = Finlands Lejon-tecken
FinlOlftjk = Finlands olympiska
förtjänstkors

FinlPftjk  =  Finska polisens
förtjänstkors

FinlVRM = Finlands Vita Ros-medalj
FinlVRO = Finlands Vita Ros-orden
FinlVRTn = Finlands Vita Ros-tecken
F(inl)VS = Finska Vetenskapssocieteten
FIntHt = Finska intendenturofficersför-

eningens hederstecken
FIP = Institutet för spännbetong-

konstruktioner
FK = Första kammaren
fk = försvarskommitté

FKE = Försvarets kommandoexpedition

FKHS = Flygkrigshögskolan

FKrHt = Finskt hederstecken för
deltagande i Finlands krig 1939-40

FKSL = Förbundet kristna lärare och
seminarister

flk = fältläkarkåren

FLSk = Finska Lotta Svärd-korset

FLUKS = Föreningen av underordnade
läkare förordnade av direktionen för
Karolinska sjukhuset och
Serafimerlasarettet

flybo = flygbasområde

FLYCO = Fria litterära yrkesutövarnas
centralorganisation

FM = fälttågsmedalj

FMCK = Frivilliga motorcykelkåren

FMK = Finskt minneskors m anl av
Finlands krig 1939-45

FMM == Finsk krigsminnesmedalj

FMpbh = Finska minnesmedaljen Pro
benignitate humana

fö = försvarsområde

FOA = Försvarets forskningsanstalt

fobef = försvarsområdesbefälhavare

Fomo = Folkrörelsernas
motororganisation

FÖS = Frivilligorganisationernas
samar-betskommitté

fp = Folkpartiet

FPG = Försäkringsbolagens
pensionsgaranti

FRA = Försvarets radioanstalt

Frd’A = Franska "d’Académie"

Frde(la)Sp = Franska "de la Sante
pub-lique"

Frdel’EPh = Franska "de TEducation
Physique"

Frdel’Ip = Franska "de l’Instruction
publique"

FrdeMagr = Franska "de Mérite
Agri-cole"

FrdeMcom = Franska orden de Mérite
Commercial

FrdeMmar = Franska Mérite
Maritimeorden

FrdeMsport = Franska orden de Mérite
Sportif

FrdeMtour = Franska orden de Mérite
Tourisme

FrftjM = Franska medaljen de la
Re-connaissance

FrHL = Franska Hederslegionen

FrimO = Svenska Frimurareorden

FrK = frihetskors

FrKA = Akademien för de fria
konsterna

FrLstrm = Franska luftstridskrafternas
flygmärke

FrM = frihetsmedalj

FrMd’A = Fransk fäktläraremedalj

X