SKBR = Sveriges kvinnliga bilkårers
riksförbund

SkD = Skånska Dagbladet

SKF = ab Svenska kullagerfabriken

SKG  = Sveriges kristliga
gymnasiströrelse

SkHS = Skogshögskolan

SkI = Skogsinstitutet

SKIF = Svenska konsulterande
ingenjörers förening

SkolVM = Föreningen för befrämjande
av skolungdomens vapenövningar

SKP = Sveriges kommunalanställdas
pensionskassa

SKR = Svenska kemiingenjörers
riksförbund

skr = skyttekrets

SkS = Samfundet för utgivande av
handskrifter rörande Skandinaviens historia

SLA = Skogs- och lantbruksakademien

SLAB = Svenska lastbil ab

SLF = Sveriges läkarförbund

SLK = Riksförbundet Sveriges
lottakårer

SLN = Sveriges lärares
nykterhetsförbund

SLR = Svenska lantmännens
riksförbund

SLS = Svenska landsbygdens
studieförbund

SLT = ab Sveriges litografiska
tryckerier

SM = svenskt mästerskap; silvermedalj;
ab Svenska metallverken

Sm = silvermärke

SMaltO = Suveräna Malteserorden

SMaltO:sFK = Suveräna Malteserordens
förtjänstkors

SMarFM = San Marinos förtjänstmedalj

SMarO = San Marinos orden

SMarS:tAgO = San Marinos orden
Santa Agatha

SMF = Svenska missionsförbundet

SMHI = Sveriges meteorologiska och
hydrologiska institut

SMI = Sveriges militära idrottsförbund

SMR = Svenska mekanisters
riksförbund

SMS = Sveriges maskinindustriförenings
standardisermgskommitté

SMU = Sveriges motorbåtsunion

SNF = Svenska naturskyddsföreningen

SNLF = Sveriges nykterhetsvänners
landsförbund

SNS =  Studieförbundet näringsliv och
samhälle

SO = Svärdsorden

SÖK = Sveriges organisationskonsulter

SOR = Sveriges orkesterföreningars
riksförbund; Sveriges optikers riksförbund

SOU = Statens offentliga utredningar

SpAXII:sO = Spanska Alfonso XII :s
orden

SpCfO == Spanska civilförtjänstorden
SPCI = Svenska pappers- och
cellulosaingen j örsf öreningen
SpCIII:sO = Spanska Carl III :s orden
SPF = Svenska prästförbundet
SpFM = Spansk fälttågsmedalj
SpGyllSkO = Spanska Gyllene Skinnets

orden
SpICO   =   Spanska  Isabel la catolicas

orden

SPK = Statens pris- och kartellnämnd
SpMerAgrO = Spanska orden El mérito

agricultural

SpMerNavO = Spanska orden El
mérito nåväl

SpMfO = Spanska militärförtjänstorden
SpMM = Spansk minnesmedalj
SPP = Svenska personal-pensionskassan
SpRO = Spanska republikens orden
SpSRPO = Spanska Orden Cruz de San

Raimundo de Penafort
SpS:tFO = Spanska Sankt
Ferdinandsorden

SR = Statstjänstemännens riksförbund
SRautKrO = Kungliga Sachsiska Rau-

tenkroneorden

SRC = Svenska ridsportens
centralförbund

SRK = Svenska Röda Korset
SSA = Svenska sockerfabriks ab
SSB = Sällskapet stallbröderna
SSF = Svenska slöjdföreningen
SSFT =  Samfundet svenska film- och

TV-ingenjörer
SSk = silversköld
SSN  =  Sjuksköterskornas samarbete i

Norden

SSR = Sveriges socionomers riksförbund
SSS = Stockholms seglarsällskap
SSSK = Stockholms skridskoseglarklubb
SSU = Sveriges socialdemokratiska
ungdomsförbund
SSUH = Sveriges studerande ungdoms

helnykterhetsförbund
ST = Stockholms-Tidningen
STAB = Svenska tändsticks ab
STAL = Svenska turbinfabriks ab

Ljungström

StbAGM = Storbritanniska Africa
General Service Medal
StbBathO = Storbritanniska B åtbörden
StbEmpO = Storbritanniska Empireor-

den

StbKM(fC) = Storbritanniska King’s
Medal for service in the cause of
freedom (for Courage)
StbMC(mB) = Storbritanniska Military

Cross (med Bar)
StbMM = Storbritannisk minnesmedalj

XVIII