SpGyllSkO = Spanska Gyllene Skinnets

orden
SpICO = Spanska Isabel la catolicas

orden

SPK = Statens pris- och kartellnämnd
SpMerAgrO == Spanska orden El mérito

agricultural
SpMerNavO = Spanska orden El mérito

nåväl

SpMfO = Spanska militärförtjänstorden
SpMM = Spansk minnesmedalj
SPP = Svenska personal-pensionskassan
SpRO = Spanska republikens orden
SpSRPO = Spanska Orden Cruz de San

Raimundo de Penafort
SpS:tFO = Spanska Sankt
Ferdinandsorden

SPV = Statens personalpensionsverk
SR = Statstjänstemannens riksförbund
SRautKrO = Kungliga Sachsiska Rau-

tenkroneorden

SRC = Svenska ridsportens
centralförbund

SRK = Svenska Röda Korset
SS = Skytteanska samfundet
SSA = Svenska sockerfabriks ab
SSB = Sällskapet stallbröderna
SSF = Svenska slöjdföreningen
SSFT = Samfundet svenska film- och

TV-ingenjörer
SSk = silversköld
SSN = Sjuksköterskornas samarbete i

Norden

SSR = Sveriges socionomers riksförbund
SSS = Stockholms seglarsällskap
SSSK = Stockholms skridskoseglarklubb
SSU = Sveriges socialdemokratiska
ungdomsförbund
SSUH = Sveriges studerande ungdoms

helnykterhetsförbund
ST = Stockholms-Tidningen
STAB = Svenska tändsticks ab
STAL = Svenska turbinfabriks ab

Ljungström
StbAGM = Storbritanniska Africa

General Service Medal
StbBathO = Storbritanniska Bathorden
StbEmpO = Storbritanniska
Empire-orden

StbKM(fC) = Storbritanniska King’s
Medal for service in the cause of
freedom (for Courage)
StbMC(mB) = Storbritanniska Military

Cross (med Bar)

StbMM = Storbritannisk minnesmedalj
StbStrumpebO = Storbritanniska
Strumpebandsorden

StbVO = Storbritanniska Victoriaorden
STC = Sveriges
trävaruhandlare-föreningars centralförbund

StD = Stockholms Dagblad
S:tEM = Stockholms Sankt Eriksmedalj
STF = Svenska turistföreningen
StHS = Stockholms högskola
STI = Stockholms tekniska institut
Stim = Svenska tonsättares
internationella musikbyrå
Stk = Storkorset av
StOff = Storofficer av
S:tOM = Norrköpings Sankt
Olovsmedalj

StR = Storriddare av
StSI = Stockholms socialinstitut
STTF = Svenska turisttrafikförbundet
StU = Stockholms universitet
StvT = Statsvetenskaplig tidskrift
SUKAB = Sveriges utrikeshandels
kompensations ab
SULF = Sveriges universitetslektorers

förening

SUOF = Svenska underofficersförbundet
SVA = Statens veterinärmedicinska

anstalt

SvBrfb = Svenska brandkårers
riksförbund
Svcfi = Sveriges centralförening för

idrottens främjande
SvD = Svenska Dagbladet
Svema = Sveriges motorfederations

automobilsektion
Svemo = Sveriges motorfederations

motorcykelsektion

Svenko = Svenska
konfektionsfabrikant-föreningen

SVF = sjövärnsflottilj
SvFfb = Svenska fäktförbundet
SvFlRoff = Svenska flottans
reserv-officersförbund

SvFM = Sveriges frivilliga motorbåtskår
SVIF = Sveriges verkstadsingenjörers

förening

SvJT == Svensk Juristtidning
SvJägF = Svenska jägareförbundet
SVK = Sjövärnskåren
SVKF = Svenska vattenkraftföreningen
Svkifb = Svenska
korporationsidrottsförbundet

SvKK = Svenska kennelklubben
SvLbev = Sveriges
luftbevaknings-förbund

Svls = Svenska livräddningssällskapet
SvM = Svärdsmedalj
Svmifb = Sveriges militära
idrottsförbund
Svofrfb = Sveriges orkesterföreningars

riksförbund
SvPIS = Svenska polisens idrotts- och

skytteförbund

SvPistsfb = Svenska
pistolskytte-förbundet

XIX