CXIII:sO = Konung Carl XIII:s orden

Daco = De anställdas
centralorganisation

DAI  =  Deutsches archäologisches
Institut

DDO = Danska Dannebrogsorden

DDOHt = Danska Dannebrogsordens
hederstecken

DE(lef)O = Danska Elefantorden

DES = Föreningen diplomerade från
Ericastiftelsen

DFrM = Dansk Frihetsmedalj

DGI = Diplomerad från Grafiska
institutet i Sthlm

DHG = Diplomerad från
Handelshögskolan i Gbg

DHI = Diplomerad från handelsinstitut

DHS = Diplomerad från
Handelshögskolan i Sthlm

DIF = Djurgårdens idrottsförening

DIHR = Diplomerad från Institutet för
högre reklamutbildning i Sthlm

DK = drätselkammare

DKB = Konungens av Danmark
belöningsmedalj

DKSN = De kristliga samfundens
nykterhetsrörelse

DM = distriktsmästerskap

DMM = Dansk minnesmedalj m anl av
Konung Christian IX:s guldbröllop

DN = Dagens Nyheter

DomDO = Dominikanska Duarteorden

DRoffHt == Danska
reservofficersför-bundets hederstecken

D Se = Doctor of Science

DSI = Diplomerad från socialinstitut

DSkGIfHt = Danska Skytte-,
gymnastik-och idrottsföreningars hederstecken

DTH = Danmarks tekniska högskola,
Köpenhamn

DVS = Danske Videnskabernes Selskab,
Köpenhamn

DXVM = Sällskapet Den XV Mars

E l == Första flygeskadern

E 2 = Andra flygeskadern

E 3 = Tredje flygeskadern

E 4 = Fjärde flygeskadern

EAF = Elektriska
arbetsgivareföreningen

EcAM = Ecuadors förtjänsttecken AI
Mérito

ECE = Economic Commission for
Europé

EEC = European Economic Community

EEG = elektroencefalogram

EFrK = Estniska Frihetskorset

EFS = Evangeliska fosterlandsstiftelsen

EFTA = European Free Trade
Association

EgyptdeSp = Egyptiska orden Decora-

tion Sportive

EgyptFO = Egyptiska förtjänstorden
EgyptIO = Egyptiska Ismailorden
EgyptMohAO = Egyptiska Mohamed

Ali-orden

EgyptNilO = Egyptiska Nilorden
EIO = Elektriska installatörsorganisa-

tionernas riksförbund
EKG = elektrokardiogram
EkmGM = Svenska pappers^ o
cellulosaingen j örsföreningars Ekmanmedalj i
guld

ELEC = European League for
Economic Cooperation

ELIF = Sveriges elektroindustriförening
EM = europamästerskap
EMt = Estlands frihetskrigs
minnestecken

EngRHS  = Engelska humanitära
sällskapets medalj
EngRKHt = Engelska Röda Korsets

hederstecken

EPU = European Payments Union
ERKO = Estniska Röda Korsets orden
Esab = Elektriska svetsnings ab,
Göteborg

ESKstk = Estniska
skyddskårsorganisationens storkors

ESO = Europeiska sydobservatoriet
ESRO = European Space Research

Organization

ESvk = Estniska Skyddskårens vita kors
Et = elittecken

EtBM = Etiopisk belöningsmedalj
EtKM = Etiopisk minnesmedalj m anl

av Kejsar Haile Selassie I:s kröning
EtKorWMM = Etiopisk Memorial

Medal of the Korean War
EtMenO = Etiopiska Menelik Il:s orden
EtSabaO = Etiopiska Sabaorden
EtSalomO = Etiopiska Salomos orden
EtSO = Etiopiska Stjärnorden
EtT(E)O = Etiopiska Treenighetsorden
EU = ekonomiskt utskott
EugGM = Prins Eugen-medaljen (i guld)

för framstående konstnärlig gärning
Euratom = European Atomic Energy

Community

EUW = European Union of Women
EVSO = Estniska Vita Stjärnans orden
ExpfÖrenftjM == Sveriges allmänna

exportförenings förtjänstmedalj i guld
EÖK = Estniska Örnkorset

F l = Västmanlands flygflottilj
F 2 = Roslagens flygkår
F 3 = Östgöta flygflottilj
F 4 = Jämtlands flygflottilj
F 5 = Krigsflygskolan
F 6 = Västgöta flygflottilj

IX