FrdeMmar = Franska Mérite
Maritimeorden

FrdeMsport = Franska orden de Mérite
Sportif

FrdeMtour = Franska orden de Mérite
Tourisme

FrftjM = Franska medaljen de la
Reconnaissance

FrHL = Franska Hederslegionen

FrimO = Svenska Frimurareorden

FrK = frihetskors

FrKA = Akademien för de fria
konsterna

FrLstrm = Franska luftstridskrafternas
flygmärke

FrM = frihetsmedalj

FrMd’A = Fransk fäktläraremedalj

FrMdel’A = Franska "la Medaille de
l’Aéronautique"

FRoffGHt = Finlands
reservofficersför-bunds gyllene förtjänsttecken

FrPAcad = Franska orden des Palmes
Académiques

FrSvSO == Franska Svarta Stjärnorden

FrVA = Franska vetenskapsakademien

FS — Fysiografiska sällskapet i Lund

FSF = Föreningen svensk fackpress

FSftjk = Finska skyddskårernas
förtjänstkors

FST = Föreningen Svenska
trädgårdsarkitekter

fst = Försvarsstaben

FSvFISM = Föreningen Sveriges Flottas
förtjänstmedalj i silver

ftJM = förtjänstmedalj

ftjt = förtjänstttecken

ftk = fälttygkåren, förtjänstkors

FU = förvaltningsutskott

FUNK = Föreningen utövande nordiska
konstnärer

FV •= flygvapnet

G = guld

GAA = Gustav Adolfs Akademien

GATT = General Agreement of Tariffs

and Trade

GbgHdlI = Göteborgs handelsinstitut
GbgHS = Göteborgs högskola
GbgMedHS = Göteborgs medicinska

högskola

GbgSI = Göteborgs socialinstitut
GCI = Gymnastiska centralinstitutet
GDG = Trafikförvaltningen
Göteborg-Dalarna-Gävle

GHT = Göteborgs Handels- och
Sjöfartstidning

GK = Gotlands kustartilleriförsvar
GKSS = Göteborgs kungliga
segelsällskap

GM = guldmedalj
Gm = guldmärke

GMP = Göteborgs Morgonpost
GP = Göteborgsposten
gr = grad

GrEvpoyaO = Grekiska Evpoyaorden
GrFenO = Grekiska Fenixorden
GrFrO = Grekiska Frälsareorden
GrG(I:s)O = Grekiska Georg I:s orden
GrS:tGKO = Grekiska Sankt Georgs

och Konstantins orden
GsFtjt = Göteborgs stads förtjänsttecken

i guld

gst = generalstabskåren, generalstaben
GTI = Göteborgs tekniska institut
GuatCMMO = Guatemalas Orden Grus

de Merito Militär
GuatQO = Guatemalas Orden del

Quetzal
GVIA Mm = Minnesmedalj m anl av

Konung Gustaf VI Adolfs 85-årsdag
GVSbm = Minnestecken m anl av

Kronprins Gustafs och Kronprinsessan

Victorias silverbröllop
G V :sJmt = Minnestecken m anl av

Konung Gustaf V:s 70-årsdag
GV:sJmtll = Minnestecken m anl av

Konung Gustaf V:s 90-årsdag
GV:sMt = Minnestecken m anl av

Konung Gustaf V:s död
GV:sOlM = Konung Gustaf V:s

olympiska minnesmedalj
GV:sPostJubM = Konung Gustaf V:s

postkongressjubileumsmedalj

h = högern

HA = Vitterhets, historie- och
antikvitetsakademien

HaitFO = Haitis Heders- och
förtjänstorden

hal = högre allmänt läroverk

HAO — Handelns
arbetsgivareorganisation

Hbg = Hälsingborg

HD = Högsta domstolen

hdlI = handelsinstitut

hedL = hedersledamot

HFI = Hemmens forskningsinstitut

HHG = Handelshögskolan i Göteborg

HHS = Handelshögskolan i Sthlm

HIK = Handels- och
industrikommissionen

Hk = hederskors

HKS = Högre konstindustriella skolan

HM = hedersmedalj

HohHO = Hohenzollernska husorden

HSB = Hyresgästernas sparkasse- och
byggnadsförening

Ht == hederstecken

HTF = Handelstjänstemannaförbundet

HTL = högre tekniskt läroverk

HushGM = Hushållningssällskaps
guldmedalj

XI