KMAGFtjt = Kronprinsessan
Margaretas arbetsnämnds för de blinda
förtjänsttecken i guld
KMH = Kungliga musikhögskolan
KMK = Kungliga motorbåtsklubben
KMO = Kunglig Majestäts Orden
Kmstk = Kommendör med stora korset

av

KNUFF = Kommittén för nya
utbildningsvägar vid de filosofiska
fakulteterna

KongoMM = Kongostatens
minnesmedalj
KongoS = Kongostatens tjänstetecken

Etoile de service
Kon:sGM = HM Konungens guldmedalj

(Hovmedaljen)

KorCDM = Korean Chungmu
Dis-tinguished Military Service Medal
KorPUCit = Republic of Korea Presi-

dential Unit Citation
korrL = korresponderande ledamot
KorUDM = Korean Ulchi Distinguished

Military Service Medal
KorWServM = Korean War Service

Medal

KOS = Kavalleriofficersskolan
KPA = Kommunernas pensionsanstalt
Krgk = krigskors
KrgM = krigsmedalj
KRO = Konstnärernas riksorganisation
KrVA = Krigsvetenskapsakademien
KS = Krigsskolan

KSAK = Kungliga svenska aeroklubben
KSHS = Kungliga sjökrigshögskolan
KSL = Kommunalförbundet för
Stockholms städs o Stockholms läns
regionala frågor

KSS = Kungliga sjökrigsskolan
KSSS = Kungliga svenska segelsällskapet
KTH = Kungliga tekniska högskolan i

Stockholm
KÖY = överstyrelsen för yrkesutbildning

L = ledamot

LA = Lantbruksakademien

LAdNassO = Luxemburgska Adolf av
Nassaus civil- och militärförtjänstorden

Lamco = Liberian American Swedish
Minerals Company

Landst = Sveriges landstormsföreningars
centralförbund

Landstoff = Landstormsofficerarnas
riksförbund

LBF = Landsbygdens byggnadsförening

LCR = Lastbilcentralernas riksförening

LEkkrO = Luxemburgska Ekkroneorden

LettSftjk = Lettiska skyddskårernas
förtjänstkors

LettSO = Lettiska orden Tre stjärnor

Ifb == landstormsförbund
LHS = Humanistiska
vetenskapssamfundet i Lund; Lantbrukshögskolan
LibAfO = Liberianska Orden Afrikas

Frigörelse

LibanCederO = Libanesiska Cederorden
LibSAO = Liberianska Står of Africa-

orden

LibSO = Liberianska Stjärnorden
LingJubM = Lingiadens
jubileumsmedalj
LingM = Minnesmedalj m anl av andra

Lingiaden (1949)

LitGedO = Litauiska Gediminas orden
Litt et Art = Litteris et Artibus
LitVytO = Litauiska Vytautas orden
LK = Livsmedelskommissionen
LKAB = Luossavaara-Kiirunavaara ab
LKF == Landskommunernas förbund
LME = Telefon ab L M Ericsson
LO = Landsorganisationen
LR = Läroverkslärarnas riksförbund
LSI = Lunds Socialinstitut
lst = landstormen

Lstrm = Luftstridskrafternas flygmärke
LT = Lantbruksförbundets tidskriftsab
LTH = Lunds tekniska högskola
LTK = Lantbruksförbundets
tidskriftsab :s korrespondensinstitut
LUP = Lokal- o
utrustningsprogramkommittén
Iv = luftvärn
Lv l = Karlsborgs luftvärnsregemente,

förutv
Lv 2 = Östgöta luftvärnsregemente,

förutv

Lv 2 G = Gotlands luftvärnsdivision
Lv 3 = Roslagens luftvärnsregemente
Lv 4 = Skånska luftvärnskåren
Lv 5 = Sundsvalls luftvärnskår
Lv 6 = Göta luftvärnsregemente
Lv 7 = Luleå luftvärnskår
LVF = Lutherska världsförbundet
Ivf = luftvärnsförening
LvOS = Luftvärnsofficersskolan
LvSS = Luftvärnsskjutskolan

M = Motormännens riksförbund; medalj

m = märke

MA = Musikaliska akademien

M A = Master of Arts

MAA = medlem av Akademisk
arkitekt-förening, Danmark

MAB = Manufaktur ab Malmö

MAF = Motorbranschens
arbetsgivareförbund

MarAO = Marockanska Alouite-orden

MB = Morgon-Bladet

MBA = Master of Business
Administration

XIV