BulgHfO 	Bulgariska orden för humanitära förtjänster
BulgMfO 	Bulgariska Militärförtjänstorden
BulgRKO 	Bulgariska Rödakorsorden
BulgS:tAO 	Bulgariska S:t Alexander-orden
CambO 		Cambodjas orden
CFB 		Centralförbundets för befälsutbildnings
CFF 		Centralkommittén för det frivilliga försvarsarbetet
CFN 		Centralförbundet för nykterhetsundervisning
ChilAM 		Chilenska förtjänsttecknet Al Merito
ChrX:esFrM 	Christian X:es Frihetsmedalj
Cia 		Compañia
Cie 		Compagnie
ColBO 		Colombianska Boyaçáorden
CTH(I) 		Chalmers Tekniska Högskola (Institut)
CubCespO 	Cubanska Cespedesorden
CXIII:sO 	Konung Carl XIII:s orden
Daco 		De anställdas centralorganisation
DBV 		De badande vännerna
DDO 		Danska Dannebrogsorden
DEO 		Danska Elefantorden
DHG 		diplomerad från handelshögskolan i Göteborg
DHS 		diplomerad från handelshögskolan i Stockholm
DM 		distriktsmästare
DNS 		Det Norske Samfund
DomDO 		Dominikanska Duarteorden
DSI 		diplomerad från Socialinstitutet
EcAM 		Ecuadors förtjänsttecken Al Merito
EFrK 		Estniska Frihetskorset
EgyptIO 	Egyptiska Ismailorden
EgyptNilO 	Egyptiska Nilorden
ERKO 		Estniska Röda Korsorden
ETH 		Eidgenössische Technische Hochschule
EVSO 		Estniska Vita Stjärnorden
EÖK 		Estniska örnkorset
FAK 		Frivilliga Automobilkåren
FBskftj 	Finlands befolkningsskydds förtjänst-
FERA 		Föreningen för Elektricitetens Rationella Användning
FFrK 		Finska Frihetskorset
FHK 		Folkhushållningskommissionen
FinlLO 		Finlands Lejonorden
FinlVRO 	Finlands Vita rosens orden
F. K. 		ledamot av riksdagens första kammare
FKHS 		Flygkrigshögskolan
FKSL 		Förbundet för Kristligt Samhällsliv (samt Fria Kristliga Seminarist- o. Lärareförbundet)
Flk, FLK 	Fältläkarkåren
FMCK 		Frivilliga Motorcykelkåren
FMM 		Finsk minnesmedalj
FMS 		Föreningen Mellanfolkligt Samarbete för Fred
fo 		försvarsområde
Frd’A 		Franska »d’Académie»
Frdel’Ip 	Franska »de l’Instruction publique»
FrdeMagr 	Franska orden de Mérite agricole
FrdeMmar 	Franska orden de Mérite maritime
FrFM 		fransk fälttågsmedalj
FrHL 		Franska Hederslegionen
FrK 		frihetskors
FrKA 		Akademien för de fria konsterna
FrKM 		fransk kolonialmedalj
FrM 		frihetsmedalj


