RPIJmt = Peter I:s 200-årsjubileums-

minnestecken

RPO = Riksteaterns publikorganisation
R-R == rättsriddare av
RRV = Riksrevisionsverket
RS = Ridskolan, Strömsholm
RSF = Riksförbundet för Sveriges
försvar
RS:tAlexO = Ryska Sankt Alexander

Nevskys orden

RS:tAndrO = Ryska Sankt
Andreasorden

RS :tAO = Ryska Sankt Anna-orden
RS :tOO = Ryska Sankt Georgs-orden
RS :tStO = Ryska Sankt Stanislaus-orden
RS :tVlO = Ryska Sankt Vladimir-orden
RumCI:sO = Rumänska Carol I:s orden
RumKrO = Rumänska Kronorden
RumMerCult = Rumänska Meritul

Cultural

RumSO = Rumänska Stjärnorden
RVÖO =  Ryska Vita Örnens orden
RÅ = Riksåklagaren

S — silver
s = socialdemokrat
S l = Upplands signalregemente
S 2 = Göta signalregemente
S 3 = Norrlands signalbataljon
S A = Société Anonyme
SA = Sveriges advokatsamfund
Saab = Svenska aeroplan ab
SAB = Sveriges allmänna
biblioteksförening

SAC = Sveriges arbetares
centralorganisation

Saco = Sveriges akademikers
centralorganisation

SAEF = Sveriges allmänna
exportförening

SAF = Svenska arbetsgivareföreningen
SAL = Svenska amerika linjen
SALK = Stockholms allmänna
lawntennisklubb

SAM = Svenska alliansmissionen
SAMK = Riksförbundet Sveriges
amatörmusikkårer
SAO = Kungliga Sachsiska Albrechts-

orden

SAOB = Svenska akademiens ordbok
SAP = Socialdemokratiska
arbetarpartiet

SAR = Svenska arkitekters riksförbund
SARA = Stockholmsdistriktets allmänna

restaurang ab

SAS = Scaninavian Airlines System
SAV = Svenska arbetsgruppen för

världsfederation

SBEF = Svenska
byggnadsentreprenör-föreningen

SBF = Sveriges bergsingenjörers

förening

SBIF = Svenska
byggnadsindustriförbundet

SBK = Svenska brukshundklubben
SBS = Svenska Blå stjärnan
SBUF = Svenska baptistsamfundets

ungdomsförbund
SCA = Svenska cellulosa ab
Scan = Skånska andelslakterier
SCF = Sveriges civilförsvarsförbund;

Svenska civilekonomföreningen
SchLFO = Schaumburg-Lippeska
förtjänstorden

SchLHO = Schaumburg-Lippeska
husorden
SCII  =  Svenska centralkommittén för

internationella ingenj örskongresser
SDS = Sydsvenska Dagbladet
Snällposten

SEB = Stockholms enskilda bank
SEIF = Svenska
elektroingenjörsföreningen

SEK = Svenska elektriska kommissionen
SEMKO = Svenska elektriska
materielkontrollanstalten

Sentab = Svenska entreprenad ab
SEO = Hertigliga Sachsen-Ernestinska

husorden
SER = Sveriges högskoleutbildade

elektroingenjörers riksförbund
SerbS:tSO = Serbiska (Jugoslaviska)

Sankt Savaorden
SF = ab Svensk filmindustri;
Svenska försäkringsföreningen;
ab Svenska fläktfabriken
sf = skytteförening
sfb = skytteförbund
SFIR = Svenska föreningen för

industriellt rättsskydd
SFP = Föreningen Sveriges
filmproducenter

SFR = Svenska företagares riksförbund
SFS = Sveriges förenade studentkårer
SGI = Sveriges grafiska industriförbund
SGU = Sveriges geologiska
undersökning

SHB = Svenska handelsbanken
SHI = Statens hantverksinstitut
SHIO = Sveriges hantverks- och

industriorganisation
SHn = Sällskapet Hjälpsamheten
SHSO = Sveriges hantverks- och
småindustriorganisation
Sl = socialinstitut
SIAB = Svenska industribyggen ab
SiamKrM = Siamesisk kröningsmedalj
SiamKrO = Siamesiska Kronorden
SiamMahaO = Siamesiska orden Maha

Chakri
SiamRO = Siamesiska Ramaorden

XVII