Mt = minnestecken
MUOS = Marinens underofficersskola
mv = med vingar
mvk = med vitt kors
MVKrO = Mecklenburgska orden
Vendernas krona
MYA = Malmö yllefabriks ab

NAF = ab Nordiska armaturfabrikerna

NAK — Norska aeroklubben

NATO = North  Atlantic Treaty Orga-

nization
NBC = Nordens bondeorganisationers

centralråd
nd(r) = nämnd(er)
NDA = Nya Dagligt Allehanda
NDM = Norsk medalj för personal som

deltagit i Norges frihetskamp
NedFM = Nederländsk medalj m anl av

prinsessan Julianas förmälning
NedKrönM = Nederländska
kröningsmedaljen

NedLO = Nederländska Lejonorden
NedMM — Nederländsk minnesmedalj

för fredskonferensen
NedOHO = Nederländska Qranien-hus-

orden

NedONO = Nederländska
Oranien-Nassauorden

NedTM = Nederländsk
tacksamhetsmedalj
NEFA = Norrköpings elektrotekniska

fabriker ab

NEM = Norsk Erindringsmedalj
NFK = Nordiskt  förbund  för
kvinnogymnastik

NFN = Nordiska  farmakopénämnden
NFrK = Norska Haakon VII:s
Frihetskors

NFrM = Norska Frihetsmedaljen
NGU = Nordisk grafikunion
NIS = Nordiska ingenjörssamfundet
NJA = Nytt juridiskt arkiv
NJF = Nordiska journalistförbundet
NJU = Nordiska järnvägsmannaunionen
NK = ab Nordiska kompaniet
NKOGM = medalj utdelad vid Konung

Olav V:s av Norge statsbesök 1959
NLöveO = Norska Löveorden
NM = nordiskt mästerskap
NO = Nordstjärneorden
Nohab = Nydqvist &amp; Holm ab
nor = för nit och redlighet i rikets tjänst
NSkHt = Norges   skytterstyr
hederstecken

NSS = Nathan Söderblom-sällskapet
NS:tOO = Norska Sankt Olavsorden
NTF = Nationalföreningen för
trafiksäkerhetens främjande
NTO = Nationaltemplarorden

NUAT = Nordisk union för alkoholfri
trafik

NVA - Det Norske
Vitenskaps-Akade-mi, Oslo

NVOffHt = Norska värnpliktiga
officerares hederstecken

NVS = Norske Videnskabers Selskab,
Trondheim

NyaSvM = Minnesmedaljen över
kolonien Nya Sverige i Amerika

O — orden, ordenssällskap

OD = Orphei drängar

OECD = Organization for  Economic
Cooperation and Development

OEEC = Organization  for   European
Economic Cooperation

Off = Offic(i)er av

OIE = Organisation Internationale des
Employeurs

OIISGbmt = Konung Oscar II:s och
Drottning Sofias
guldbröllopsminnestecken

OILsJmt = Konung Oscar II:s
jubile-umsminnestecken

ÖK = Sveriges   oljekonsumenters
riksförbund

OldHFO = Oldenburgska Hus- och
förtjänstorden

ONUCM = Organisation des Nations
Unies au Congo Medal

OS = Olympiska spelen

OTA — Organisation Mondiale du
Tou-risme et de l’Automobilisme

P l = Göta pansarlivgarde

P l G — Göta  pansarlivgardes  kompani

på Gotland

P 2 = Skånska pansarregementet
P 3* = Södermanlands pansarregemente,

förutv

P 4 = Skaraborgs pansarregemente
P 5 = Norrbottens pansarbataljon
PanBO = Panamas Balboaorden
PanSM = Panamas   medalj   La   Solida-

ridad

PatrS(ällsk) = Patriotiska sällskapet
PB = Par Bricole

PBk = Portugisiska   Benemerenciakorset
P(da)CO = Portugisiska orden da Con-

cei9äo

PdeMMO = Portugisiska de Mérito
militärorden

PersLSO = Persiska Lejonorden
PeruAM = Perus förtjänstorden AI Me-

rito

PeruSO = Perus Solorden
PHSjöfO = Portugisiska Henrik
Sjöfararens orden

PiMM = Minnesmedalj över de Svenska
pionjärerna i USA

XV