L — ledamot

LA = Lantbruksakademien
LAdNassO = Luxemburgska   Adolf   av
Nassaus civil- och
militärförtjänstorden
Lamco = Liberian American Swedish

Minerals Company
Landst = Sveriges landstormsföreningars

centralförbund
Landstoff = Landstormsoff icerarnas

riksförbund

LBF = Landsbygdens   byggnadsförening
LCR = Lastbilcentralernas   riksförening
LEkkrO = Luxemburgska
Ekkroneorden

LettSftjk = Lettiska skyddskårernas
förtjänstkors

LettSO = Lettiska orden Tre stjärnor
Ibf = landstormsförbund
LHS = Humanistiska
vetenskapssamfundet i Lund
LibAfO = Liberianska   Orden   Afrikas

Frigörelse

LibanCederO = Libanesiska Cederorden
LibSAO = Liberianska  Står  of  Africa-

orden

LibSO = Liberianska Stjärnorden
LingJubM = Lingiadens
jubileumsmedalj
LingM = Minnesmedalj m anl av andra

Lingiaden (1949)

LitGedO = Litauiska Gediminas orden
Litt et Art = Litteris et Artibus
LitVytO = Litauiska Vytautas orden
LK = Livsmedelskommissionen
LKAB = Luossavaara-Kiirunavaara   ab
LKF = Landskommunernas förbund
LME = Telefon ab L M Ericsson
LO = Landsorganisationen
LR = Läroverkslärarnas riksförbund
LSI = Lunds Socialinstitut
lst = landstormen

Lstrm = Luftstridskrafternas flygmärke
LT = Lantbruksförbundets tidskriftsab
LTK = Lantbruksförbundets
tidskriftsab : s korrespondensinstitut
Iv = luftvärn
Lv l = Karlsborgs luftvärnsregemente,

förutv

Lv 2 = Östgöta luftvärnsregemente,
förutv

Lv 2 G — Gotlands luftvärnsdivision
Lv 3 = Roslagens  luftvärnsregemente
Lv 4 = Skånska luftvärnskåren
Lv 5 = Sundsvalls luftvärnskår
Lv 6 = Göteborgs   luftvärnskår
Lv 7 = Luleå   luftvärnskår
LVF = Lutherska världsförbundet
Ivf = luftvärnsförening
LvOS = Luftvärnsofficersskolan
LvSS = Luftvärnsskjutskolan

M = Motormännens riksförbund; medalj

m — märke

MA = Musikaliska akademien

M A = Master of Arts

MAB = Manufaktur ab Malmö

MAF = Motorbranschens
arbetsgivareförbund

MarAO = Marockanska Alouite-orden

MB = Morgon-Bladet

MBA = Master of Business
Administration

mbr = med briljanter

md = för medborgerliga dygder

MEA = Militär ekiperings ab

rnekl — med eklöv

MexMarO — Mexikanska
marinförtjänst-orden

MexMilO = Mexikanska
militärförtjänstorden

MexÖO = Mexikanska Örnorden

mf — för medborgerlig förtjänst

mgk = med guldkors

M GM = Metro-Goldwyn-Mayer

MGrO = Mecklenburgska   Griporden

mgstj — med gyllene stjärna

MHF = Motorförarnas
Helnykterhetsförbund

mhjosv = med hjälm och  svärd

MHS = Militärhögskolan

milbef = militärbefälhavare

milbefstab = militärbefälstab

milo = militärområde

MIT = Massachusetts Institute of
Technology

Mk = minneskors

MK(N, O, S, V) = Marinkommando
(Nord, Ost, Syd, Väst)

mkr = med kraschan

mkrgd = med krigsdekoration

mlk = marinläkarkåren

MM = minnesmedalj

MMFK = Mecklenburgska
militärför-tjänstkorset

MMT = Malmö mekaniska tricotfabriks
ab

MNC = Metallnormcentralen

MO = Militieombudsman

MonS:tCO = Monegaskiska Sankt
Carloorden

MontDO = Montenegrinska Danilo I:s
orden

MPI = Militärpsykologiska institutet

mrk = med rött kors

M Se = Master of Science

MSD = Master of Science in Dentistry

msn = med snäcka

msp = med spänne

msposv = med spänne och svärd

mstj = med stjärna

msv = med svärd

MT = Morgon-Tidningen

XIV