PIPO = Portugisiska   orden   Instru?äo
Publica

pistsk = pistolskyttekrets

PK = Publicistklubben

PKN = Priskontrollnämnden

PKO = Portugisiska Kristiorden

PLM = ab Plåtmanufaktur

PMd’AO = Portugisiska Militär de
Aviz-orden

PMerAgrlndO = Portugisiska orden
Mé-rito Agricola e Industrial

PMfO = Portugisiska
militärförtjänstorden

PolFK = Polskt förtjänstkors

PolRest = Polska orden Polonia
Resti-tuta

POS = Pansarofficersskolan

PR == Public relations

PrJohO = Preussiska Johanniterorden

PrJrk = Preussiska Järnkorset

PrKrFO = Preussiska kronans
Förtjänstorden

PrKrO = Preussiska Kronorden

ProP(atr) = Sällskapet Pro Patria

PrRÖO = Preussiska Röda örns orden

PrSvÖO = Preussiska Svarta Örnsorden

PS = Pansartruppskolan, Skövde

PSBd’AO = Portugisiska Säo Bento  de
Avizorden

PS:tJO = Portugisiska Sankt Jakobs
orden

PTSO = Portugisiska Torn- och
Svärdsorden

PåvlGK = Påvliga Gyllene korset

PåvlHGO = Påvliga Heliga Gravens
Orden

PåvlHLK = Påvliga   Heliga   Landets
Kors

PåvlOPEetP = Påvliga  orden  Pro
Ecc-lesia et Pontifice

PåvlPO = Påvliga Piusorden

PåvlS:tGrO = Påvliga  Sankt   Gregorius
den stores orden

PåvlS:tSO = Påvliga   Sankt   Sylvesters
orden

R = riddare av

RAF = Royal Air Force

RAS = Royal Asiatic Society i London

RATI = Rationaliseringstekniska
institutet

REF = Riksnämnden för ekonomisk
försvarsberedskap

RESO = Folkrörelsernas rese- och
semesterorganisation

RFA = Riksförsäkringsanstalten

Rfs = Riksföreningen för simningens
främjande

RFSU = Riksförbundet för sexuell
upplysning

RFV = Riksförsäkringsverket

RIF = Riksidrottsförbundet

RILEM = Institutet för provning av

byggnadsmaterial och konstruktioner
RK = Röda Korset

RKA = Ränte- och
kapitalförsäkrings-anstalten

RLF = Riksförbundet landsbygdens folk
RLSF = Riksluftskyddsförbundet
RMR = Riksförbundet mot reumatism
RPIJmt = Peter   I:s
200-årsjubileums-minnestecken

RPO = Riksteaterns  publikorganisation
R-R = rättsriddare  av
RRV = Riksrevisionsverket
RS = Ridskolan, Strömsholm
RSF = Riksförbundet för Sveriges
försvar
RSrtAlexO = Ryska Sankt Alexander

Nevskys orden

RS:tAndrO = Ryska Sankt
Andreas-orden

RSrtAO = Ryska Sankt Anna-orden
RS :tGO = Ryska Sankt Georgs-orden
RS:tStO = Ryska Sankt Stanislaus-orden
RSrtVlO = Ryska Sankt Vladimir-orden
RumCIrsO = Rumänska Carol I:s orden
RumKrO = Rumänska Kronorden
RumMerCult = Rumänska Meritul Cul-

tural

RumSO = Rumänska Stjärnorden
RVÖO = Ryska Vita Örnens orden
RÅ = Riksåklagaren

S = silver
s = socialdemokrat
S l = Upplands signalregemente
S 2 = Göta signalkår
S 3 = Norrlands signalbataljon
SA = Sveriges advokatsamfund
SAAB = Svenska aeroplan ab
SAB = Sveriges allmänna
biblioteksförening

SAC = Sveriges arbetares
centralorganisation

Saco = Sveriges akademikers
centralorganisation

SAEF = Sveriges allmänna
exportförening

SAF = Svenska arbetsgivareföreningen
SAL = Svenska amerika linjen
SALK — Stockholm allmänna
lawntennisklubb

SAM = Svenska alliansmissionen
SAMK = Riksförbundet   Sveriges
amatörmusikkårer
SAO = Kungliga Sachsiska Albrechtsor-

den

SAOB = Svenska akademiens ordbok
SAP = Socialdemokratiska arbetarpartiet
SAR = Svenska arkitekters riksförbund

XVI