StbStrumpebO = Storbritanniska Strum*

pebandsorden

StbVO = Storbritanniska Victoriaorden
STC = Sveriges trävaruhandlareför-

eningars centralförbund
StD = Stockholms Dagblad
S:tEM = Stockholms Sankt Eriksmedalj
STF = Svenska turistföreningen
StHS = Stockholms högskola
STI = Stockholms tekniska institut
Stim = Svenska tonsättares
internationella musikbyrå
Stk = Storkorset av
StOff = Storofficer av
S:tOM = Norrköpings Sankt
Olovsmedalj

StR = Storriddare av
StSI = Stockholms socialinstitut
STTF = Svenska turisttrafikförbundet
StU = Stockholms universitet
StvT = Statsvetenskaplig tidskrift
SUKAB = Sveriges utrikeshandels
kompensations ab
SULF = Sveriges universitetslektorers

förening

SVA = Statens veterinärmedicinska
anstalt

SvBrfb = Svenska brandkårers
riksförbund
Svcfi = Sveriges centralförening för

idrottens främjande
SvD = Svenska Dagbladet
Svema = Sveriges motorfederations

automob ilsektion
Svemo = Sveriges motorfederations

motorcykelsektion

Svenko = Svenska
konfektionsfabrikant-föreningen

SVF = sjövärnsflottilj
SvFfb = Svenska fäktförbundet
SvFlRoff = Svenska flottans reservoffi-

cersförbund

SvFM = Sveriges frivilliga motorbåtskår
S VIF = Sveriges verkstads ingenjörer s

förening

SvJT = Svensk Juristtidning
SvJägF = Svenska jägareförbundet
SVK = Sjövärnskåren
SVKF = Svenska vattenkraftföreningen
Svkifb = Svenska
korporationsidrottsförbundet

SvKK == Svenska kennelklubben
SvLbev = Sveriges luftbevakningsför-

bund

Svls = Svenska livräddningssällskapet
SvM = Svärdsmedalj
Svmifb = Sveriges militära
idrottsförbund

Svofrfb = Sveriges orkesterföreningars
riksförbund

SvPIS = Svenska polisens idrotts- och

skytteförbund
SvPistsfb = Svenska pistolskytteförbun-

det

SVR = Svenska väg- och
vattenbyggares riksförbund

Svrifb = Sveriges riksidrottsförbund
SvRIJubM = Sveriges
riksidrottsförbunds jubileumsmedalj
SvRoff = Svenska arméns och
flygvapnets reservoff icersförbund
SvRsp = Svensk ridsport
SvRuoff = Svenska
reservunderofficers-förbundet

Svsfb  =  Sveriges skytteförbunds
överstyrelse
SvsfbBernM  =  Svenska skytteförbunds

Bernadottemedalj
SvSpsfb   =   Svenska  sportskytteförbun-

det

SvSRS =  Svenska sällskapet för
räddning av skeppsbrutna
SvTF = Svenska teknologföreningen
SvUB = Sveriges ungdomsberedskap
SWVFO = Storhertigliga
Sachsen-weimarska orden Vita Falken
SXK = Svenska kryssarklubben
SYJF = Sveriges yngre juristers förening
SYK = Stockholms yachtklubb
SYL = Sveriges yngre läroverkslärares

förening

SYLF = Sveriges yngre läkares förening
SYPF = Sveriges yngre prästers
förening.

SyrFO = Syriens förtjänstorden
SYVF = Sveriges yngre veterinärers

förening
SO = Skolöverstyrelsen

T l = Svea trängregemente
T 2 = Göta trängregemente
T 3 = Norrlands trängregemente
T 4 = Skånska trängregementet
TA = Tidningarnas arbetsgivareförening
TadjNelAO = Sultanatet Tadjourahs
orden Nichan-el-Anouar
TB = Sällskapet tjänstemannabröderna
TBV = Tjänstemännens
bildningsverksamhet

TChO = Turkiska Chefkat-orden
TCO = Tjänstemännens
centralorganisation

TEFO  =  Svenska
textilforskningsinstitutet

tf = för tapperhet i fält
TFK = Transportforskningskommis-

sionen

TFR = Statens tekniska forskningsråd
TGO = Trafik ab
Grängesberg-Oxelösund

TGOJ = Trafik ab
Grängesberg—Oxelösunds järnvägar

XIX