Th(ai)KrM = Thailands kröningsmedalj
Th(ai)KrO = Thailändska Kronorden
Th(ai)VEO = Thailändska Vita
Elefantorden

THM = Tandläkarhögskolan i Malmö
THS = Tandläkarhögskolan i Sthlm
Tibo = Träindustriens
branschorganisation i Industriförbundet
TIO = Turkiska Imtiaz-orden
TIU = Tandläkarinstitutet i Umeå
TjslVLO = Tjeckoslovakiska Vita
Lejonets orden

TLI = Tekniska läroverkens
ingenjörsförbund

TLL = Tekniska läroverkens
lärarförbund

TLM •= Turkiska Liakhat-medaljen
TMChM = Turkiska krigsmedaljen

Charb medaljasse el Järnhalvmånen
TMO = Turkiska Meschidie-orden
TNC = Tekniska nomenklaturcentralen
TOO = Turkiska Osmanié-orden
TÖS = Trängofficersskolan
TR = ab Trafikrestauranger
TS = Tidningsstatistik ab
ts = för tapperhet till sjöss
TSA = Tidskrift för Sveriges
advokatsamfund

TT — Tidningarnas telegrambyrå
TU = Svenska tidningsutgivareförening-

en

TunAmanO = Tunisiska Amanorden
TunNI = Tunisiska orden Nichan-Iftik-

har

TV = Television
TyskGK = Tyska Kreuz in Gold
TyskJohO == Tyska Johanniterorden
TyskJrk = Tyska järnkorset
TyskKolAbz = Tyska Kolonialabzeichen
TyskKrFtjk = Tyska Kriegsverdienst-

kreuz

TyskOlHt = Tyska olympiska
hederstecknet

TyskOM = Tyska ordens marianerkors
TyskOstM = Tyska Östmedaljen
TyskPleMér = Tyska orden Pour le Mé-

rite för vetenskap och konst
TyskRFO = Förbundsrepubliken
Tysklands Förtjänstorden
TyskRyttk = Tyska Ryttarkorset
TyskVerwAbz = Tyska Verwundeten

Abzeichen
TyskÖO = Tyska Örnens orden

UD = Utrikesdepartementet

UIA = Union of International
Associations

UK = uttagningskommitté

UL = utländsk ledamot

UNAC = United Nations Appeal for
Children

UNEFM = United Nations Emergency
Force Medal

Unesco == United Nations Educational
Scientific and Cultural Organization

UngFO = Ungerska Förtjänstorden

UngKrMM = Ungersk
krigsminnesmedalj

UngKrO = Ungerska Kronans orden

UngRFO = Ungerska republikens
Förtjänstorden

Unicef = United Nations International
Children’s Emergency Fund

UNIPEDE = Union Internationale des
Producteurs et Distributeurs d’Energie
Electrique

Uniscan = ekonomiska unionen mellan
Storbritannien och de tre
skandinaviska länderna

UNKorM = United Nations Korean
Service Medal

UNKRA = United Nations Korean
Re-construction Agency

UNM = United Nations Medal

UNOGIL = United Nations
Observatio-nal Group in Libanon

UNRib = United Nations Ribbon

Unrra = United Nations Relief and Re-’
habilitation Administration

UNSCEAR = United Nations Scientific
Committe ön the Effects of Atomic
Radiation

UNT = Upsala Nya Tidning

UNTAB = United Nations Technical
Assistance Board

UP = United Press

UPI = United Press International

Ut = utmärkelsetecken

VA = Vetenskapsakademien

VACelsM = Vetenskapsakademiens
Cel-siusmedalj

VARA = Västsveriges allmänna
restaurang ab

WCC = World Council of Churches

VDN = Varudeklarationsnämnden

Vectu = Svenska
tidningsutgivareföreningens veckotidningssektion

VenBO(Ip) = Venezuelas Bolivarorden
(Instruccion Publico)

Vendel’Ip = Venezolanska
"delTnstruc-tion publique"

VenMO = Venezuelas Francisco De
Mi-randa-orden

VGM = Vasamedaljen i guld

WHO = World Health Organization

VHS = Veterinärhögskolan

VJ = Vecko-Journalen

VM .= Världsmästerskap

VMFM = Världsmästerskapstävlingärna
i fotboll 1958 förtjänstmedalj

XX