WMO = World Meteorological
Organi-zation

VO = Vasaorden

VoffRfb = Värnpliktiga officerares
riksförbund

WPC = World Power Conference

VS = Vetenskapssocieteten i Uppsala

VSL = Vetenskapssocieteten i Lund

VSU = Vetenskapssamhället i Uppsala

VU = verkställande utskott

VuoffRfb = Värnpliktiga
underofficerares riksförbund

VVK = Väg- och vattenbyggnadskåren

VVS = Vetenskaps- och
vitterhetssamhället i Göteborg

VV :styr = Väg- och
vattenbyggnadsstyrelsen

WürtChKr = Wurttembergska
Charlot-tenkreutz

WürtKrO = Wurttembergska Kronorden

YK = Yrkeskvinnors klubb
YMCA = Young Men’s Christian
Association

YSF = Yrkeskvinnors samarbetsförbund
Å&amp;Å = Ahlén &amp; Åkerlunds förlags ab

ÖB = Överbefälhavare
ÖC = Östgöta Correspondenten
OF = Östergötlands Folkblad
ÖFO = Österrikiska Förtjänstorden
ÖFrJO = Österrikiska Franz
Josephsorden

ÖHT = Österrikiska republikens
hederstecken

ÖJKrO = Österrikiska Järnkroneorden
ÖLeopO = Österrikiska Leopoldsorden
ÖMk = Österrikiska militärkorset
ÖMM = Österrikiska minnesmedaljen m
anl av Kejsar Franz Josephs
50(60)-åriga regeringsjubileum
ÖS = Örlogsmannasällskapet
ÖSalvO = Österrikiska Salvatorsorden
ÖSARA = Östra Sveriges allmänna
restaurang ab
Ö-UngS:tStefO = Österrikisk-Ungerska

Sankt Stefansorden
ÖÄ = överståthållarämbetet

XXI